R 1080 720
NO ./textures/greystone.xpm
SO ./textures/redbrick.xpm
EA ./textures/wood.xpm
WE ./textures/wood.xpm
S ./textures/greenlight.xpm
C 255,200,160
F 122,122,122

11111111111111111
10000000000000001
10200000200000201
10000000000000001
10002000200020001    11
10000000000000001111101
10202020N02020200000001
10000000000000001111101
10002000200200001   111
10000000000000001
10200000200002001
10000000000000001
11111111111111111
