R 0 0
F 255, 255,255
C 0, 50, 100
NO ./textures/bluestone.xpm
WE ./textures/mossy.xpm
EA ./textures/colorstone.xpm
SO ./textures/eagle.xpm
S  ./textures/barrel.xpm

111111111111111
100000001000001
100000001000001
100000001000001
100000001000001
100111111000001
1000000N0000001
100000000000001
111111111111111
