R 1920 1080
F 0, 100,200
C 0, 50, 100
NO ./textures/bluestone.png
WE ./textures/mossy.png
EA ./textures/colorstone.png
SO ./textures/eagle.png
S  ./textures/guard.png

111111111111111
100000001000001
100000001000001
100000001000001
100000001000001
100111111000001
100000000000001
1000000S0000001
100000000000001
100000000000001
100000000000001
100000000000001
100000000000001
111111111111111
