R 1280 720
NO ./textures/eagle.xpm
SO ./textures/greystone.xpm
WE ./textures/redbrick.xpm
EA ./textures/redbrick.xpm
S ./textures/greenlight.xpm
F 43,46,74
C 233,69,69

        1111111111111111111111111
        1000000000110000000000001
        1011000001110000002000001
        1001000000000000020000001
111111111011000001110000000200001
100000000011000001110111100011111
11110111111111011100000010001
11110111111111011101010010001
11000000110101011100000010001
10002000000000001100000010001
10000000000000001101010010001
11100011111101011101110012N01
  10001    10001 100000010001
  11111    11111 111111111111
